10
w,w,w,w,w,w,w,w,w,w,w
w,e,0,0,0,w,p1,0,w,s,w
w,0,0,0,w,w,w,0,w,0,w
w,0,0,0,w,0,g2,0,w,0,w
w,0,0,0,g1,p3,w,0,w,0,w
w,0,0,0,w,0,w,0,w,0,w
w,0,0,0,w,w,w,0,w,0,w
w,p3,0,0,w,w,w,0,0,0,w
w,n,n,n,n,n,n,n,n,n,w
-
w,w,w,w,w,w,w,w,w,w,w
w,s,w,l2,w,w,0,0,w,e,w
w,0,w,0,w,w,w,0,w,g3,w
w,0,w,0,w,0,w,0,0,0,w
w,0,w,0,w,p1,g3,0,0,0,w
w,0,w,0,g1,0,w,0,0,0,w
w,0,w,0,w,w,w,0,0,0,w
w,0,0,0,0,w,0,0,0,0,w
w,n,n,n,n,n,n,n,n,n,w