7
w,w,w,w,w,w,w
w,w,w,s,w,w,w
w,w,w,g1,w,w,w
w,w,0,i9,0,w,w
w,w,w,g3,w,w,w
w,w,w,g4,w,w,w
w,w,w,i8,w,w,w
w,w,w,g6,0,0,w
w,w,w,g@,w,0,w
w,w,w,g8,w,g#,w
w,w,w,g9,w,t@7,w
w,w,w,g0,w,w,w
w,w,w,e,l!,w,w
w,w,w,w,w,w,w
-
w,w,w,w,w,w,w
w,0,0,s,0,0,w
w,0,0,p5,w,0,w
w,0,0,0,w,0,w
w,0,p4,0,w,0,w
w,0,0,w,w,p2,w
w,pl,0,p6,w,0,w
w,0,0,p6,w,0,w
w,0,p1,0,w,0,w
w,0,0,0,w,g@,w
w,p3,0,0,w,p0,w
w,0,t#2,0,w,w,w
w,0,0,0,g!,e,w
w,w,w,w,w,w,w