12
n,w,n,w,n,w,n,w,n,w,n,w
w,n,e,0,t!3,n,0,0,0,0,s,n
n,0,n,0,n,w,n,w,n,0,n,w
w,0,0,0,w,0,0,0,w,0,0,n
n,0,n,0,n,0,n,0,0,0,0,w
w,n,w,0,w,n,0,0,w,n,0,n
n,0,0,0,0,0,0,w,0,0,0,w
w,n,w,n,w,n,w,n,w,n,w,n
-
w,n,w,n,w,n,w,n,w,n,w,n
n,s,0,0,0,0,n,e,0,0,0,w
w,n,g!,n,w,n,w,n,w,g!,w,n
n,0,0,w,0,g!,0,w,0,0,0,w
w,0,0,g!,0,n,0,n,0,n,g!,n
n,g!,n,w,0,0,n,w,n,w,0,w
w,0,0,0,w,0,0,g!,0,0,0,n
n,w,n,w,n,w,n,w,n,w,n,w