5
w,w,w,w,w,
w,0,s,0,w,
w,p1,0,l1,w,
w,0,0,0,w,
w,g1,n,i1,w,
w,0,0,0,w,
w,w,w,w,w
-
w,w,w,w,w,
w,0,s,0,w,
w,0,0,0,w,
w,0,0,0,w,
w,0,0,0,w,
w,0,0,0,w,
w,w,w,w,w