03
w,w,w,
w,s,w,
w,0,w,
w,0,w,
w,0,w,
w,e,w,
w,w,w
-
w,w,w,
w,s,w,
w,0,w,
w,0,w,
w,0,w,
w,e,w,
w,w,w
