09
w,w,w,w,w,w,w,w,w,
w,0,w,0,w,0,0,0,w,
w,e,0,0,w,0,w,0,w,
w,w,w,0,w,0,w,0,w,
w,0,0,0,w,0,w,0,w,
w,0,w,w,w,0,w,0,w,
w,0,w,w,w,0,w,0,w,
w,0,w,w,w,0,w,0,w,
w,0,0,0,0,0,w,0,w,
w,w,w,w,w,w,w,0,w,
w,s,0,0,0,0,0,0,w,
w,w,w,w,w,w,w,w,w
-
w,w,w,w,w,w,w,w,w,
w,0,0,0,w,0,0,0,w,
w,1,w,e,w,s,w,0,w,
w,0,w,w,w,w,w,0,w,
w,0,0,0,0,0,w,0,w,
w,w,w,w,w,0,w,0,w,
w,w,w,w,w,0,w,0,w,
w,w,w,w,w,0,w,0,w,
w,0,0,0,0,0,w,0,w,
w,0,w,w,w,w,w,0,w,
w,0,0,0,0,0,0,0,w,
w,w,w,w,w,w,w,w,w

