05
w,w,w,w,w,
w,0,0,0,w,
w,0,w,0,w,
w,G@,w,0,w,
w,0,w,0,w,
w,G!,w,0,w,
w,0,w,e,w,
w,0,w,w,w,
w,0,0,s,w,
w,w,w,w,w
-
w,w,w,w,w,
w,0,0,e,w,
w,0,w,w,w,
w,0,w,w,w,
w,p@,0,0,w,
w,w,w,0,w,
w,0,0,p!,w,
w,0,w,w,w,
w,0,0,s,w,
w,w,w,w,w
