9
w,w,w,w,w,w,w,w,w,
w,e,w,w,w,w,w,w,w,
w,0,0,0,w,w,w,w,w,
w,w,w,0,w,w,w,w,w,
w,0,0,0,0,w,w,w,w,
w,0,w,w,0,0,0,l!,w,
w,0,w,w,w,w,w,w,w,
w,0,w,w,0,0,0,0,w,
w,0,0,0,0,w,w,s,w,
w,w,w,w,w,w,w,w,w
-
w,w,w,w,w,w,w,w,w,
w,w,w,w,w,w,w,w,w,
w,0,0,0,0,0,0,0,w,
w,0,w,w,g!,w,w,0,w,
w,0,w,0,0,0,w,0,w,
w,0,g!,0,e,0,g!,0,w,
w,0,w,0,0,0,w,0,w,
w,0,w,w,g!,w,w,0,w,
w,0,0,0,0,0,0,s,w,
w,w,w,w,w,w,w,w,w

