9
1,1,1,1,1,1,1,1,1,
1,3,1,1,1,1,1,1,1,
1,0,0,0,1,1,1,1,1,
1,1,1,0,1,1,1,1,1,
1,0,0,0,0,1,1,1,1,
1,0,1,1,0,0,0,7,1,
1,0,1,1,1,1,1,1,1,
1,0,1,1,0,0,0,0,1,
1,0,0,0,0,1,1,2,1,
1,1,1,1,1,1,1,1,1

1,1,1,1,1,1,1,1,1,
1,1,1,1,1,1,1,1,1,
1,0,0,0,0,0,0,0,1,
1,0,1,1,6,1,1,0,1,
1,0,1,0,0,0,1,0,1,
1,0,6,0,3,0,6,0,1,
1,0,1,0,0,0,1,0,1,
1,0,1,1,6,1,1,0,1,
1,0,0,0,0,0,0,2,1,
1,1,1,1,1,1,1,1,1

