3
w,w,w,
w,s,w,
w,0,w,
w,0,w,
w,0,w,
w,g,w,
w,w,w
-
w,w,w,
w,s,w,
w,0,w,
w,0,w,
w,0,w,
w,g,w,
w,w,w
