05
w,w,w,w,w,
w,e,g@,s,w,
w,w,w,0,w,
w,0,i!,0,w,
w,0,w,g!,w,
w,0,l@,0,w,
w,w,w,w,w
-
w,w,w,w,w,
w,e,g!,s,w,
w,w,w,0,w,
w,0,i@,0,w,
w,0,w,g@,w,
w,0,l!,0,w,
w,w,w,w,w
