06
w,w,w,w,w,w,
w,w,w,0,s,w,
w,p$,w,0,0,w,
w,e,w,w,0,w,
w,G!,w,w,g#,w,
w,0,l!,i@,0,w,
w,w,w,w,w,w
-
w,w,w,w,w,w,
w,0,p#,w,e,w,
w,0,w,w,g$,w,
w,0,0,0,0,w,
w,0,0,w,0,w,
w,s,0,w,0,w,
w,w,w,w,w,w
