05
w,w,w,w,w,
w,n,n,n,w,
w,w,s,n,w,
w,n,g!,n,w,
w,l@,0,n,w,
w,n,g#,n,w,
w,l$,0,n,w,
w,n,i!,n,w,
w,l@,0,n,w,
w,n,i#,n,w,
w,e,0,l$,w,
w,w,w,w,w
-
w,w,w,w,w,
w,n,n,n,w,
w,l!,s,n,w,
w,n,g@,n,w,
w,l#,0,n,w,
w,n,g$,n,w,
w,l!,0,n,w,
w,n,i@,n,w,
w,l#,0,0,w,
w,w,i$,w,w,
w,0,0,e,w,
w,w,w,w,w
