5
n,n,n,n,n
n,n,s,n,n
n,n,g2,n,n
n,p3,0,n,n
n,n,g4,n,n
n,p5,0,n,n
n,n,g6,n,n
n,p7,0,n,n
n,n,g8,n,n
n,e,0,p9,n
n,n,n,n,n
-
n,n,n,n,n
n,p2,s,n,n
n,n,g3,n,n
n,p4,0,n,n
n,n,g5,n,n
n,p6,0,n,n
n,n,g7,n,n
n,p8,0,0,n
n,n,g9,n,n
n,0,0,e,n
n,n,n,n,n