05
n,n,n,n,n,
n,n,s,n,n,
n,n,g!,n,n,
n,p@,0,n,n,
n,n,g#,n,n,
n,p$,0,n,n,
n,n,g!,n,n,
n,p@,0,n,n,
n,n,g#,n,n,
n,e,0,p$,n,
n,n,n,n,n
-
n,n,n,n,n,
n,p!,s,n,n,
n,n,g@,n,n,
n,p#,0,n,n,
n,n,g$,n,n,
n,p!,0,n,n,
n,n,g@,n,n,
n,p#,0,0,n,
n,n,g$,n,n,
n,0,0,e,n,
n,n,n,n,n
