10
w,w,w,w,w,w,w,w,w,w
w,0,0,0,0,0,0,g!,s,w
w,0,0,0,0,0,0,w,w,w
w,0,0,0,0,0,0,0,0,w
w,0,0,0,0,0,0,0,0,w
w,0,0,0,0,0,0,0,0,w
w,0,0,0,0,0,0,0,0,w
w,0,w,g1,w,0,0,0,0,w
w,0,g3,p2,w,0,0,0,e,w
w,w,w,w,w,w,w,w,w,w
-
w,w,w,w,w,w,w,w,w,w
w,p1,0,0,0,0,0,0,S,w
w,0,0,0,0,0,0,0,0,w
w,0,0,0,0,0,0,0,0,w
w,0,0,0,0,0,0,0,0,w
w,0,w,0,0,0,0,0,0,w
w,0,0,0,0,0,0,0,0,w
w,w,w,w,0,0,0,0,0,w
w,E,g2,p3,0,0,0,0,t!2,w
w,w,w,w,w,w,w,w,w,w
