10
w,w,w,w,w,w,w,w,w,w,
w,0,0,0,0,0,0,g!,s,w,
w,0,0,0,0,0,0,w,w,w,
w,0,0,0,0,0,0,0,0,w,
w,0,0,0,0,0,0,0,0,w,
w,0,0,0,0,0,0,0,0,w,
w,0,0,0,0,0,0,0,0,w,
w,0,w,g!,w,0,0,0,0,w,
w,0,g#,p@,w,0,0,0,e,w,
w,w,w,w,w,w,w,w,w,w
-
w,w,w,w,w,w,w,w,w,w,
w,p!,0,0,0,0,0,0,S,w,
w,0,0,0,0,0,0,0,0,w,
w,0,0,0,0,0,0,0,0,w,
w,0,0,0,0,0,0,0,0,w,
w,0,w,0,0,0,0,0,0,w,
w,0,0,0,0,0,0,0,0,w,
w,w,w,w,0,0,0,0,0,w,
w,E,g@,p#,0,0,0,0,0,w,
w,w,w,w,w,w,w,w,w,w
