7
w,w,w,w,w,w,w
w,0,g2,0,w,s,w
w,g!,w,0,w,0,w
w,0,0,0,0,0,w
w,0,0,0,0,0,w
w,0,0,0,0,0,w
w,0,0,0,0,0,w
w,0,w,0,w,w,w
w,0,w,0,w,0,w
w,i1,w,0,w,0,w
w,l2,w,w,w,0,w
w,e,0,0,w,0,w
w,w,w,w,w,w,w
-
w,w,w,w,w,w,w
w,s,w,0,w,0,w
w,0,w,0,w,w,w
w,0,0,0,0,0,w
w,0,0,0,0,0,w
w,0,0,0,0,0,w
w,0,0,0,0,0,w
w,w,w,0,0,0,w
w,0,w,0,w,p1,w
w,0,0,0,w,g2,w
w,0,w,w,w,0,w
w,0,0,t!16,w,e,w
w,w,w,w,w,w,w