05
w,w,w,w,w,
w,0,s,t!3,w,
w,p!,0,l!,w,
w,0,0,0,w,
w,g!,n,i!,w,
w,0,E,0,w,
w,w,w,w,w
-
w,w,w,w,w,
w,0,s,0,w,
w,0,0,0,w,
w,0,0,0,w,
w,0,0,0,w,
w,0,e,0,w,
w,w,w,w,w